....@.....
.#.....#..
.#.....#..
..........
.#.....#..
..#####...
..........
#.#...#.#.
##.....#..
#.#....#..