@.........
#######...
#..#..#...
...####...
#.......##
#..#..#.##
...#..#...
....##....
..#....#..
##########