...........
#########..
...........
.#########.
...........
#########..
...........
.#########.
........@#.
##########.